NO textures/brick.png
WE textures/wood.png
SO textures/grass.png
EA textures/dirt.png
F     18,53,25
C     153,204,255



111111111
1N0001001
100000001
100011001
100000001
111111111