NO textures/Bricks.png
WE textures/TreeRings.png
SO textures/MossOver.png
EA textures/Dirt.png
F     18,53,25
C     153,204,255



111111111
100001001
1000N0001
100011001
100000001
111111111